111111111111111111
11111111C111111111
111111110P11111111
11111111E111111111
111111111111111111