11111111
10000011
10101011
11E010C1
11100111
111P0001
11111111