1111111111111
1111111111111
1111111111111
1000000000001
1111111111111
1000P11111111
1111000000001
1000000020001
1C00000000001
1111111101111
110E000001111
1111111111111