111111111111
111111111111
111111110011
11111C00PE11
111111111111